***********\n
*** IAFGI *\n
***L*   * *\n
*M  I S * *\n
* WA*H*** *\n
*   I F * *\n
*   * GL* *\n
*M  * S * *\n
***H***H* *\n 
***PAFLSG *\n
***********\n
